"a" = (/obj/effect/spawner/structure/window/reinforced/shuttle,/obj/structure/fans/tiny/invisible,/turf/open/floor/plating,/area/shuttle/arrival)
"b" = (/obj/machinery/light/directional/south,/turf/open/floor/mineral/titanium,/area/shuttle/arrival)
"c" = (/turf/template_noop,/area/template_noop)
"e" = (/obj/structure/railing{dir = 8},/obj/machinery/light/directional/north,/turf/open/floor/mineral/titanium,/area/shuttle/arrival)
"g" = (/obj/structure/closet/wardrobe/mixed,/turf/open/floor/plating,/area/shuttle/arrival)
"i" = (/obj/machinery/power/shuttle_engine/propulsion{dir = 4},/obj/docking_port/mobile/arrivals{name = "keplerstation arrivals shuttle"},/turf/open/floor/plating/airless,/area/shuttle/arrival)
"l" = (/obj/machinery/light/small/directional/north,/turf/open/floor/plating,/area/shuttle/arrival)
"m" = (/obj/structure/railing{dir = 8},/turf/open/floor/mineral/titanium,/area/shuttle/arrival)
"n" = (/obj/machinery/requests_console/directional/west,/turf/open/floor/mineral/titanium,/area/shuttle/arrival)
"o" = (/obj/machinery/door/airlock/titanium{name = "Arrivals Shuttle Airlock"},/turf/open/floor/mineral/titanium,/area/shuttle/arrival)
"p" = (/obj/structure/window/reinforced/tinted/spawner/directional/west,/obj/structure/closet/wardrobe/mixed,/turf/open/floor/plating,/area/shuttle/arrival)
"q" = (/obj/machinery/light/small/directional/east,/obj/structure/chair/comfy/shuttle{dir = 8},/turf/open/floor/mineral/titanium/blue,/area/shuttle/arrival)
"s" = (/obj/machinery/vending/wallmed/directional/west,/obj/machinery/light/directional/north,/turf/open/floor/mineral/titanium,/area/shuttle/arrival)
"t" = (/obj/item/clothing/suit/hazardvest{desc = "A high-visibility lifejacket complete with whistle and slot for oxygen tanks."; name = "emergency lifejacket"},/obj/item/clothing/suit/hazardvest{desc = "A high-visibility lifejacket complete with whistle and slot for oxygen tanks."; name = "emergency lifejacket"},/obj/item/clothing/suit/hazardvest{desc = "A high-visibility lifejacket complete with whistle and slot for oxygen tanks."; name = "emergency lifejacket"},/obj/item/clothing/suit/hazardvest{desc = "A high-visibility lifejacket complete with whistle and slot for oxygen tanks."; name = "emergency lifejacket"},/obj/item/clothing/suit/hazardvest{desc = "A high-visibility lifejacket complete with whistle and slot for oxygen tanks."; name = "emergency lifejacket"},/obj/item/tank/internals/emergency_oxygen{pixel_x = 3},/obj/item/tank/internals/emergency_oxygen{pixel_x = 3},/obj/item/tank/internals/emergency_oxygen{pixel_x = 3},/obj/item/tank/internals/emergency_oxygen{pixel_x = 3},/obj/item/tank/internals/emergency_oxygen{pixel_x = 3},/obj/item/clothing/mask/breath{pixel_x = -3; pixel_y = -3},/obj/item/clothing/mask/breath{pixel_x = -3; pixel_y = -3},/obj/item/clothing/mask/breath{pixel_x = -3; pixel_y = -3},/obj/item/clothing/mask/breath{pixel_x = -3; pixel_y = -3},/obj/item/clothing/mask/breath{pixel_x = -3; pixel_y = -3},/obj/item/clothing/head/utility/hardhat/orange{name = "protective hat"; pixel_y = 9},/obj/item/clothing/head/utility/hardhat/orange{name = "protective hat"; pixel_y = 9},/obj/item/clothing/head/utility/hardhat/orange{name = "protective hat"; pixel_y = 9},/obj/item/clothing/head/utility/hardhat/orange{name = "protective hat"; pixel_y = 9},/obj/item/clothing/head/utility/hardhat/orange{name = "protective hat"; pixel_y = 9},/obj/structure/closet/crate/internals,/obj/machinery/atmospherics/components/unary/vent_pump/on/layer4{dir = 1},/turf/open/floor/plating,/area/shuttle/arrival)
"u" = (/obj/machinery/power/shuttle_engine/propulsion/burst/left{dir = 4},/turf/open/floor/plating/airless,/area/shuttle/arrival)
"w" = (/obj/machinery/computer{dir = 4; name = "Shuttle computer"},/obj/machinery/light/directional/south,/turf/open/floor/mineral/titanium/blue,/area/shuttle/arrival)
"x" = (/obj/structure/window/reinforced/tinted/spawner/directional/west,/obj/machinery/portable_atmospherics/canister/air,/turf/open/floor/plating,/area/shuttle/arrival)
"y" = (/obj/structure/fans/tiny/invisible,/obj/machinery/door/airlock/titanium{name = "Arrivals Shuttle Airlock"},/turf/open/floor/plating,/area/shuttle/arrival)
"z" = (/obj/machinery/power/shuttle_engine/propulsion/burst/right{dir = 4},/turf/open/floor/plating/airless,/area/shuttle/arrival)
"A" = (/turf/closed/wall/mineral/titanium,/area/shuttle/arrival)
"C" = (/obj/structure/railing{dir = 8},/obj/machinery/light/directional/south,/turf/open/floor/mineral/titanium,/area/shuttle/arrival)
"D" = (/obj/machinery/light/small/directional/east,/obj/structure/chair/comfy/shuttle{dir = 8},/obj/item/radio/intercom/directional/south,/turf/open/floor/mineral/titanium/blue,/area/shuttle/arrival)
"E" = (/obj/machinery/light/small/directional/south,/turf/open/floor/plating,/area/shuttle/arrival)
"F" = (/obj/machinery/power/shuttle_engine/heater{dir = 4},/obj/structure/window/reinforced/spawner/directional/west,/turf/open/floor/plating/airless,/area/shuttle/arrival)
"G" = (/obj/machinery/power/shuttle_engine/propulsion{dir = 4},/turf/open/floor/plating/airless,/area/shuttle/arrival)
"J" = (/obj/structure/table/reinforced,/obj/item/storage/medkit/regular,/turf/open/floor/mineral/titanium,/area/shuttle/arrival)
"M" = (/turf/open/floor/mineral/titanium/blue,/area/shuttle/arrival)
"O" = (/obj/structure/chair/comfy/shuttle{dir = 8},/turf/open/floor/mineral/titanium/blue,/area/shuttle/arrival)
"Q" = (/turf/open/floor/plating,/area/shuttle/arrival)
"U" = (/obj/machinery/computer{dir = 4; name = "Shuttle computer"},/obj/machinery/light/directional/north,/turf/open/floor/mineral/titanium/blue,/area/shuttle/arrival)
"X" = (/obj/machinery/space_heater,/turf/open/floor/plating,/area/shuttle/arrival)
"Y" = (/turf/open/floor/mineral/titanium,/area/shuttle/arrival)
"Z" = (/obj/item/radio/intercom/directional/west,/turf/open/floor/mineral/titanium,/area/shuttle/arrival)

(1,1,1) = {"
cccAAayaAAAAAAA
AAAAsOmOeOxlXFz
aUqAnOmOmOxQtFG
aJYoMMMMMMQQQFi
awDAZOmOmOpQgFG
AAAAbOCOCOpEgFu
cccAAaAaAaAAAAA
"}
